0 1 2 3 4 5 6 7 2 3 4 4 5 6 7 0 2 3 4 2 3 4 5 6 0 1 2 3 4 5 6 7 0 1 2 3 4 5 6 7 2 3 4 4 5 6 7 0 2 3 4 2 3 4 5 6 0 1 2 3 4 5 6 7
1 1 1 1 1 1 1 1 2 3 4 2 3 4 5 6 2 3 4 7 0 1 2 3 0 1 2 3 4 5 6 7 0 1 2 3 4 5 6 7 2 3 4 4 5 6 7 0 2 3 4 2 3 4 5 6 0 1 2 3 4 5 6 7
0 1 2 3 4 5 6 7 3 2 4 4 5 2 4 8 2 3 4 7 0 1 2 3 0 1 2 3 4 5 6 7 0 1 2 3 4 5 6 7 2 3 4 4 5 6 7 0 2 3 4 2 3 4 5 6 0 1 2 3 4 5 6 7
2 2 2 2 2 2 2 2 1 1 1 1 1 1 1 1 2 3 4 2 3 4 5 6 0 1 2 3 4 5 6 7 0 1 2 3 4 5 6 7 2 3 4 4 5 6 7 0 2 3 4 2 3 4 5 6 0 1 2 3 4 5 6 7
2 3 4 5 6 7 0 1 2 2 2 2 2 2 2 2 2 3 4 5 6 7 0 1 2 2 2 2 2 2 2 2 0 1 2 3 4 5 6 7 2 3 4 4 5 6 7 0 2 3 4 2 3 4 5 6 0 1 2 3 4 5 6 7
2 3 4 2 3 4 5 6 0 1 2 3 4 5 6 7 2 3 4 2 3 4 5 6 0 1 2 3 4 5 6 7 0 1 2 3 4 5 6 7 2 3 4 4 5 6 7 0 2 3 4 2 3 4 5 6 0 1 2 3 4 5 6 7
2 3 4 7 0 1 2 3 0 1 2 3 4 5 6 7 2 3 4 7 0 1 2 3 0 1 2 3 4 5 6 7 0 1 2 3 4 5 6 7 2 3 4 4 5 6 7 0 2 3 4 2 3 4 5 6 0 1 2 3 4 5 6 7
1 1 1 1 1 1 1 1 2 3 4 4 5 6 7 0 2 3 4 7 0 1 2 3 0 1 2 3 4 5 6 7 0 1 2 3 4 5 6 7 2 3 4 4 5 6 7 0 2 3 4 2 3 4 5 6 0 1 2 3 4 5 6 7
1 1 1 1 1 1 1 1 2 3 4 4 5 6 7 0 2 3 4 2 3 4 5 6 0 1 2 3 4 5 6 7 0 1 2 3 4 5 6 7 2 3 4 4 5 6 7 0 2 3 4 2 3 4 5 6 0 1 2 3 4 5 6 7
1 1 1 1 1 1 1 1 2 3 4 4 5 6 7 0 2 3 4 5 6 7 0 1 2 2 2 2 2 2 2 2 0 1 2 3 4 5 6 7 2 3 4 4 5 6 7 0 2 3 4 2 3 4 5 6 0 1 2 3 4 5 6 7
1 1 1 1 1 1 1 1 2 3 4 4 5 6 7 0 2 3 4 7 0 1 2 3 0 1 2 3 4 5 6 7 0 1 2 3 4 5 6 7 2 3 4 4 5 6 7 0 2 3 4 2 3 4 5 6 0 1 2 3 4 5 6 7
1 1 1 1 1 1 1 1 2 3 4 4 5 6 7 0 2 3 4 2 3 4 5 6 0 1 2 3 4 5 6 7 0 1 2 3 4 5 6 7 2 3 4 4 5 6 7 0 2 3 4 2 3 4 5 6 0 1 2 3 4 5 6 7
1 1 1 1 1 1 1 1 2 3 4 4 5 6 7 0 2 3 4 5 6 7 0 1 2 2 2 2 2 2 2 2 0 1 2 3 4 5 6 7 2 3 4 4 5 6 7 0 2 3 4 2 3 4 5 6 0 1 2 3 4 5 6 7
1 1 1 1 1 1 1 1 2 3 4 4 5 6 7 0 2 3 4 2 3 4 5 6 0 1 2 3 4 5 6 7 0 1 2 3 4 5 6 7 2 3 4 4 5 6 7 0 2 3 4 2 3 4 5 6 0 1 2 3 4 5 6 7
1 1 1 1 1 1 1 1 2 3 4 4 5 6 7 0 2 3 4 7 0 1 2 3 0 1 2 3 4 5 6 7 0 1 2 3 4 5 6 7 2 3 4 4 5 6 7 0 2 3 4 2 3 4 5 6 0 1 2 3 4 5 6 7
1 1 1 1 1 1 1 1 2 3 4 4 5 6 7 0 2 3 4 2 3 4 5 6 0 1 2 3 4 5 6 7 0 1 2 3 4 5 6 7 2 3 4 4 5 6 7 0 2 3 4 2 3 4 5 6 0 1 2 3 4 5 6 7
2 3 4 7 0 1 2 3 0 1 2 3 4 5 6 7 2 3 4 7 0 1 2 3 0 1 2 3 4 5 6 7 0 1 2 3 4 5 6 7 2 3 4 4 5 6 7 0 2 3 4 2 3 4 5 6 0 1 2 3 4 5 6 7
2 3 4 7 0 1 2 3 0 1 2 3 4 5 6 7 2 3 4 7 0 1 2 3 0 1 2 3 4 5 6 7 0 1 2 3 4 5 6 7 2 3 4 4 5 6 7 0 2 3 4 2 3 4 5 6 0 1 2 3 4 5 6 7
2 3 4 7 0 1 2 3 0 1 2 3 4 5 6 7 2 3 4 7 0 1 2 3 0 1 2 3 4 5 6 7 0 1 2 3 4 5 6 7 2 3 4 4 5 6 7 0 2 3 4 2 3 4 5 6 0 1 2 3 4 5 6 7
2 3 4 7 0 1 2 3 0 1 2 3 4 5 6 7 2 3 4 7 0 1 2 3 0 1 2 3 4 5 6 7 0 1 2 3 4 5 6 7 2 3 4 4 5 6 7 0 2 3 4 2 3 4 5 6 0 1 2 3 4 5 6 7 
2 3 4 7 0 1 2 3 0 1 2 3 4 5 6 7 2 3 4 7 0 1 2 3 0 1 2 3 4 5 6 7 0 1 2 3 4 5 6 7 2 3 4 4 5 6 7 0 2 3 4 2 3 4 5 6 0 1 2 3 4 5 6 7
2 3 4 7 0 1 2 3 0 1 2 3 4 5 6 7 2 3 4 7 0 1 2 3 0 1 2 3 4 5 6 7 0 1 2 3 4 5 6 7 2 3 4 4 5 6 7 0 2 3 4 2 3 4 5 6 0 1 2 3 4 5 6 7
2 3 4 7 0 1 2 3 0 1 2 3 4 5 6 7 2 3 4 7 0 1 2 3 0 1 2 3 4 5 6 7 0 1 2 3 4 5 6 7 2 3 4 4 5 6 7 0 2 3 4 2 3 4 5 6 0 1 2 3 4 5 6 7
0 1 2 3 4 5 6 7 2 3 4 4 5 6 7 0 2 3 4 2 3 4 5 6 0 1 2 3 4 5 6 7 0 1 2 3 4 5 6 7 2 3 4 4 5 6 7 0 2 3 4 2 3 4 5 6 0 1 2 3 4 5 6 7
1 1 1 1 1 1 1 1 2 3 4 2 3 4 5 6 2 3 4 7 0 1 2 3 0 1 2 3 4 5 6 7 0 1 2 3 4 5 6 7 2 3 4 4 5 6 7 0 2 3 4 2 3 4 5 6 0 1 2 3 4 5 6 7 
0 1 2 3 4 5 6 7 2 3 4 4 5 6 7 0 2 3 4 2 3 4 5 6 0 1 2 3 4 5 6 7 0 1 2 3 4 5 6 7 2 3 4 4 5 6 7 0 2 3 4 2 3 4 5 6 0 1 2 3 4 5 6 7
1 1 1 1 1 1 1 1 2 3 4 2 3 4 5 6 2 3 4 7 0 1 2 3 0 1 2 3 4 5 6 7 0 1 2 3 4 5 6 7 2 3 4 4 5 6 7 0 2 3 4 2 3 4 5 6 0 1 2 3 4 5 6 7
1 1 1 1 1 1 1 1 2 3 4 4 5 6 7 0 2 3 4 2 3 4 5 6 0 1 2 3 4 5 6 7 0 1 2 3 4 5 6 7 2 3 4 4 5 6 7 0 2 3 4 2 3 4 5 6 0 1 2 3 4 5 6 7
1 1 1 1 1 1 1 1 2 3 4 4 5 6 7 0 2 3 4 5 6 7 0 1 2 2 2 2 2 2 2 2 0 1 2 3 4 5 6 7 2 3 4 4 5 6 7 0 2 3 4 2 3 4 5 6 0 1 2 3 4 5 6 7
1 1 1 1 1 1 1 1 2 3 4 4 5 6 7 0 2 3 4 7 0 1 2 3 0 1 2 3 4 5 6 7 0 1 2 3 4 5 6 7 2 3 4 4 5 6 7 0 2 3 4 2 3 4 5 6 0 1 2 3 4 5 6 7 
1 1 1 1 1 1 1 1 2 3 4 4 5 6 7 0 2 3 4 2 3 4 5 6 0 1 2 3 4 5 6 7 0 1 2 3 4 5 6 7 2 3 4 4 5 6 7 0 2 3 4 2 3 4 5 6 0 1 2 3 4 5 6 7
1 1 1 1 1 1 1 1 2 3 4 4 5 6 7 0 2 3 4 5 6 7 0 1 2 2 2 2 2 2 2 2 0 1 2 3 4 5 6 7 2 3 4 4 5 6 7 0 2 3 4 2 3 4 5 6 0 1 2 3 4 5 6 7
0 1 2 3 4 5 6 7 2 3 4 4 5 6 7 0 2 3 4 2 3 4 5 6 0 1 2 3 4 5 6 7 0 1 2 3 4 5 6 7 2 3 4 4 5 6 7 0 2 3 4 2 3 4 5 6 0 1 2 3 4 5 6 7
1 1 1 1 1 1 1 1 2 3 4 2 3 4 5 6 2 3 4 7 0 1 2 3 0 1 2 3 4 5 6 7 0 1 2 3 4 5 6 7 2 3 4 4 5 6 7 0 2 3 4 2 3 4 5 6 0 1 2 3 4 5 6 7
0 1 2 3 4 5 6 7 3 2 4 4 5 2 4 8 2 3 4 7 0 1 2 3 0 1 2 3 4 5 6 7 0 1 2 3 4 5 6 7 2 3 4 4 5 6 7 0 2 3 4 2 3 4 5 6 0 1 2 3 4 5 6 7
2 2 2 2 2 2 2 2 1 1 1 1 1 1 1 1 2 3 4 2 3 4 5 6 0 1 2 3 4 5 6 7 0 1 2 3 4 5 6 7 2 3 4 4 5 6 7 0 2 3 4 2 3 4 5 6 0 1 2 3 4 5 6 7
2 3 4 5 6 7 0 1 2 2 2 2 2 2 2 2 2 3 4 5 6 7 0 1 2 2 2 2 2 2 2 2 0 1 2 3 4 5 6 7 2 3 4 4 5 6 7 0 2 3 4 2 3 4 5 6 0 1 2 3 4 5 6 7
2 3 4 2 3 4 5 6 0 1 2 3 4 5 6 7 2 3 4 2 3 4 5 6 0 1 2 3 4 5 6 7 0 1 2 3 4 5 6 7 2 3 4 4 5 6 7 0 2 3 4 2 3 4 5 6 0 1 2 3 4 5 6 7
2 3 4 7 0 1 2 3 0 1 2 3 4 5 6 7 2 3 4 7 0 1 2 3 0 1 2 3 4 5 6 7 0 1 2 3 4 5 6 7 2 3 4 4 5 6 7 0 2 3 4 2 3 4 5 6 0 1 2 3 4 5 6 7
1 1 1 1 1 1 1 1 2 3 4 4 5 6 7 0 2 3 4 7 0 1 2 3 0 1 2 3 4 5 6 7 0 1 2 3 4 5 6 7 2 3 4 4 5 6 7 0 2 3 4 2 3 4 5 6 0 1 2 3 4 5 6 7
1 1 1 1 1 1 1 1 2 3 4 4 5 6 7 0 2 3 4 2 3 4 5 6 0 1 2 3 4 5 6 7 0 1 2 3 4 5 6 7 2 3 4 4 5 6 7 0 2 3 4 2 3 4 5 6 0 1 2 3 4 5 6 7
1 1 1 1 1 1 1 1 2 3 4 4 5 6 7 0 2 3 4 5 6 7 0 1 2 2 2 2 2 2 2 2 0 1 2 3 4 5 6 7 2 3 4 4 5 6 7 0 2 3 4 2 3 4 5 6 0 1 2 3 4 5 6 7
1 1 1 1 1 1 1 1 2 3 4 4 5 6 7 0 2 3 4 7 0 1 2 3 0 1 2 3 4 5 6 7 0 1 2 3 4 5 6 7 2 3 4 4 5 6 7 0 2 3 4 2 3 4 5 6 0 1 2 3 4 5 6 7
1 1 1 1 1 1 1 1 2 3 4 4 5 6 7 0 2 3 4 2 3 4 5 6 0 1 2 3 4 5 6 7 0 1 2 3 4 5 6 7 2 3 4 4 5 6 7 0 2 3 4 2 3 4 5 6 0 1 2 3 4 5 6 7
1 1 1 1 1 1 1 1 2 3 4 4 5 6 7 0 2 3 4 5 6 7 0 1 2 2 2 2 2 2 2 2 0 1 2 3 4 5 6 7 2 3 4 4 5 6 7 0 2 3 4 2 3 4 5 6 0 1 2 3 4 5 6 7
1 1 1 1 1 1 1 1 2 3 4 4 5 6 7 0 2 3 4 2 3 4 5 6 0 1 2 3 4 5 6 7 0 1 2 3 4 5 6 7 2 3 4 4 5 6 7 0 2 3 4 2 3 4 5 6 0 1 2 3 4 5 6 7
1 1 1 1 1 1 1 1 2 3 4 4 5 6 7 0 2 3 4 7 0 1 2 3 0 1 2 3 4 5 6 7 0 1 2 3 4 5 6 7 2 3 4 4 5 6 7 0 2 3 4 2 3 4 5 6 0 1 2 3 4 5 6 7
1 1 1 1 1 1 1 1 2 3 4 4 5 6 7 0 2 3 4 2 3 4 5 6 0 1 2 3 4 5 6 7 0 1 2 3 4 5 6 7 2 3 4 4 5 6 7 0 2 3 4 2 3 4 5 6 0 1 2 3 4 5 6 7
2 3 4 7 0 1 2 3 0 1 2 3 4 5 6 7 2 3 4 7 0 1 2 3 0 1 2 3 4 5 6 7 0 1 2 3 4 5 6 7 2 3 4 4 5 6 7 0 2 3 4 2 3 4 5 6 0 1 2 3 4 5 6 7
2 3 4 7 0 1 2 3 0 1 2 3 4 5 6 7 2 3 4 7 0 1 2 3 0 1 2 3 4 5 6 7 0 1 2 3 4 5 6 7 2 3 4 4 5 6 7 0 2 3 4 2 3 4 5 6 0 1 2 3 4 5 6 7
2 3 4 7 0 1 2 3 0 1 2 3 4 5 6 7 2 3 4 7 0 1 2 3 0 1 2 3 4 5 6 7 0 1 2 3 4 5 6 7 2 3 4 4 5 6 7 0 2 3 4 2 3 4 5 6 0 1 2 3 4 5 6 7
2 3 4 7 0 1 2 3 0 1 2 3 4 5 6 7 2 3 4 7 0 1 2 3 0 1 2 3 4 5 6 7 0 1 2 3 4 5 6 7 2 3 4 4 5 6 7 0 2 3 4 2 3 4 5 6 0 1 2 3 4 5 6 7 
2 3 4 7 0 1 2 3 0 1 2 3 4 5 6 7 2 3 4 7 0 1 2 3 0 1 2 3 4 5 6 7 0 1 2 3 4 5 6 7 2 3 4 4 5 6 7 0 2 3 4 2 3 4 5 6 0 1 2 3 4 5 6 7
2 3 4 7 0 1 2 3 0 1 2 3 4 5 6 7 2 3 4 7 0 1 2 3 0 1 2 3 4 5 6 7 0 1 2 3 4 5 6 7 2 3 4 4 5 6 7 0 2 3 4 2 3 4 5 6 0 1 2 3 4 5 6 7
2 3 4 7 0 1 2 3 0 1 2 3 4 5 6 7 2 3 4 7 0 1 2 3 0 1 2 3 4 5 6 7 0 1 2 3 4 5 6 7 2 3 4 4 5 6 7 0 2 3 4 2 3 4 5 6 0 1 2 3 4 5 6 7
0 1 2 3 4 5 6 7 2 3 4 4 5 6 7 0 2 3 4 2 3 4 5 6 0 1 2 3 4 5 6 7 0 1 2 3 4 5 6 7 2 3 4 4 5 6 7 0 2 3 4 2 3 4 5 6 0 1 2 3 4 5 6 7
1 1 1 1 1 1 1 1 2 3 4 2 3 4 5 6 2 3 4 7 0 1 2 3 0 1 2 3 4 5 6 7 0 1 2 3 4 5 6 7 2 3 4 4 5 6 7 0 2 3 4 2 3 4 5 6 0 1 2 3 4 5 6 7 
0 1 2 3 4 5 6 7 2 3 4 4 5 6 7 0 2 3 4 2 3 4 5 6 0 1 2 3 4 5 6 7 0 1 2 3 4 5 6 7 2 3 4 4 5 6 7 0 2 3 4 2 3 4 5 6 0 1 2 3 4 5 6 7
1 1 1 1 1 1 1 1 2 3 4 2 3 4 5 6 2 3 4 7 0 1 2 3 0 1 2 3 4 5 6 7 0 1 2 3 4 5 6 7 2 3 4 4 5 6 7 0 2 3 4 2 3 4 5 6 0 1 2 3 4 5 6 7
1 1 1 1 1 1 1 1 2 3 4 4 5 6 7 0 2 3 4 2 3 4 5 6 0 1 2 3 4 5 6 7 0 1 2 3 4 5 6 7 2 3 4 4 5 6 7 0 2 3 4 2 3 4 5 6 0 1 2 3 4 5 6 7
1 1 1 1 1 1 1 1 2 3 4 4 5 6 7 0 2 3 4 5 6 7 0 1 2 2 2 2 2 2 2 2 0 1 2 3 4 5 6 7 2 3 4 4 5 6 7 0 2 3 4 2 3 4 5 6 0 1 2 3 4 5 6 7
1 1 1 1 1 1 1 1 2 3 4 4 5 6 7 0 2 3 4 7 0 1 2 3 0 1 2 3 4 5 6 7 0 1 2 3 4 5 6 7 2 3 4 4 5 6 7 0 2 3 4 2 3 4 5 6 0 1 2 3 4 5 6 7 
1 1 1 1 1 1 1 1 2 3 4 4 5 6 7 0 2 3 4 2 3 4 5 6 0 1 2 3 4 5 6 7 0 1 2 3 4 5 6 7 2 3 4 4 5 6 7 0 2 3 4 2 3 4 5 6 0 1 2 3 4 5 6 7
1 1 1 1 1 1 1 1 2 3 4 4 5 6 7 0 2 3 4 5 6 7 0 1 2 2 2 2 2 2 2 2 0 1 2 3 4 5 6 7 2 3 4 4 5 6 7 0 2 3 4 2 3 4 5 6 0 1 2 3 4 5 6 7